ARE	AA R
ARE(2)	ER
BROWSER	B R AW Z ER
HELLO	HH AH L OW
HELLO(2)	HH EH L OW
HI	HH AY
HOW	HH AW
IS	IH Z
MUSIC	M Y UW Z IH K
MY	M AY
NAME	N EY M
OPEN	OW P AH N
PEPPER	P EH P ER
PLAY	P L EY
SAMEER	S AA M IH R
SOME	S AH M
STOP	S T AA P
WHAT	W AH T
WHAT(2)	HH W AH T
YOU	Y UW
